%%%%%%%%%%%%%%%%%%%%
%----%--------%----%
%-%%-%-%%--%%-%.%%-%
%-%-----%--%-----%-%
%-%-%%-%%--%%-%%-%-%
%-----------%-%----%
%-%----%%%%%%-%--%-%
%-%----%----%-%--%-%
%-%----%-%%%%-%--%-%
%-%-----------%--%-%
%-%%-%-%%%%%%-%-%%-%
%----%---P----%----%
%%%%%%%%%%%%%%%%%%%%