%%%%%%%%%%%%%%%%%%%%%%%%%%%%
%------------%%------------%
%-%%%%-%%%%%-%%-%%%%%-%%%%-%
%.%%%%-%%%%%-%%-%%%%%-%%%%-%
%-%%%%-%%%%%-%%-%%%%%-%%%%-%
%--------------------------%
%-%%%%-%%-%%%%%%%%-%%-%%%%-%
%-%%%%-%%-%%%%%%%%-%%-%%%%-%
%------%%----%%----%%------%
%%%%%%-%%%%%-%%-%%%%%-%%%%%%
%%%%%%-%%%%%-%%-%%%%%-%%%%%%
%%%%%%-%------------%-%%%%%%
%%%%%%-%-%%%%--%%%%-%-%%%%%%
%--------%--------%--------%
%%%%%%-%-%%%%%%%%%%-%-%%%%%%
%%%%%%-%------------%-%%%%%%
%%%%%%-%-%%%%%%%%%%-%-%%%%%%
%------------%%------------%
%-%%%%-%%%%%-%%-%%%%%-%%%%-%
%-%%%%-%%%%%-%%-%%%%%-%%%%-%
%---%%----------------%%---%
%%%-%%-%%-%%%%%%%%-%%-%%-%%%
%%%-%%-%%-%%%%%%%%-%%-%%-%%%
%------%%----%%----%%------%
%-%%%%%%%%%%-%%-%%%%%%%%%%-%
%------------P-------------%
%%%%%%%%%%%%%%%%%%%%%%%%%%%%